,,,,,,,,,.,,,,,,,,,,
,;;,,,,,,.,#,,,,~~~,
,;,,,,,,,.,;;,O,~+~,
,;,,,,,,,.,;#,,~++~,
,,,,,,,,,.,#;#,~++~,
,,,,,,;,,.,#,,,~~~~,
,,,,,,;;,.,,,,#,,,,,
,,,,,,;;,...........
,#,,,,,,,,,,.,,,,,,,
,,,;;,,,,,,,.;;;;;,,
,,,;#;;,,O,,.,,,;;,,
,,,;;;;,,,,,.,,,,,##
,,#;;;;#,,,,.,++,,#,
,,,,,,,,,,,,.,++###,
,,,,,,,,,,,,.,,,,,,,